211111111111111111111111111111111111111111111112
100000000000000000000000000000000000000000000001
100000000000000000000000000000000000000000000001
100000000000000000000000000000000000000000000001
100000000000000000000000000000000000000000000001
100000000000000000000000000000000000000000000001
100000000000000000000000000000000000000000000001
100000000000000000000000000000000000000000000001
100000000000000000000001100000000000000000000001
100000000000000000000001100000000000000000000001
100000000000000000000001100000000000000000000001
100000000000000011111112211111110000000000000001
100000000000000011111112211111110000000000000001
100000000000000000000001100000000000000000000001
100000000000000000000001100000000000000000000001
100000000000000000000001100000000000000000000001
100000000000000000000000000000000000000000000001
100000000000000000000000000000000000000000000001
100000000000000000000000000000000000000000000001
100000000000000000000000000000000000000000000001
100000000000000000000000000000000000000000000001
100000000000000000000000000000000000000000000001
100000000000000000000000000000000000000000000001
211111111111111111111111111111111111111111111112