211111111111111111111111111111111111111111111112
100000000000000000000001100000000000000000000001
100000000000000000000001100000000000000000000001
100000000000000000000001100000000000000000000001
100000000000000100000000000000001000000000000001
100000000000000100000000000000001000000000000001
100000000000000100000000000000001000000000000001
100000001111111100000000000000001111111100000001
100000000000000000000001100000000000000000000001
100000000000000000000001100000000000000000000001
100000000000000000000001100000000000000000000001
111100000000000011111112211111110000000000001111
111100000000000011111112211111110000000000001111
100000000000000000000001100000000000000000000001
100000000000000000000001100000000000000000000001
100000000000000000000001100000000000000000000001
100000001111111100000000000000001111111100000001
100000000000000100000000000000001000000000000001
100000000000000100000000000000001000000000000001
100000000000000100000000000000001000000000000001
100000000000000000000001100000000000000000000001
100000000000000000000001100000000000000000000001
100000000000000000000001100000000000000000000001
211111111111111111111111111111111111111111111112